Jeena Sikha Diya Marna Sikha Diya – Do Lafzo ki Kahaani
Ik Kuddi – Udta Punjab
Mujhko Barsaat Bana Lo – Junooniyat 
Bol Do Na Zara – Azahar
Ijazat – One Night Stand
Sanam Re – Sanam Re
Sab Tera- Baghi 
Kuch to hai – Do Lafzon Ki Kahani
Bolna-Kapoor & Sons
Tum Hi Ho- Ashiqui 2
Ankhiya Nu Ankhiya – Do Laafzo Ki Kahaani
Bol Do Na Zara- Azhar
Itni Si Baat – Azhar
Raaz Rebooted – The sound of Raaz
Tum ho to Lagta Hai – Album
Main Teri Yaadon Me – Sanam Teri Kasam
Tera Chehra Jab Nazar Aaye – Sanam Teri Kasam
Agar Tum Saath Ho – Tamasha
Ha Hansi Ban Gaye – Humari Adhuri Kahaani
Dhai Aakhar Prem Kahani – Ishq Click
21 Miley Ho Tum Humko Bade Naseebo se – Love Fever
Yeh kaisi jagah
Baatein ye kabhi na Tum Bhoolna – Khamoshiyaan 
Main Hoon Hero Tera – Hero
Kabhi jo badal Barse – Jackpot
Ji Huzoori – Ki and Ka
Agar tu Hota Na Rote Hum – Baaghi
Yahi Hoo Mai – Album 2015 singles
Haal e dil Mera Puchho na Sanam – Sanam Teri Kasam
Tu chahiye – Bajrangi Bhai Jaan
Lag Jaa Gale – Wo Kaun Thi 1964
Khoobsurat hai wo Itna – Rog ,2005
Ab ke Sajan Saawan Me – chupke chupke 1975
Do Lafzo Ki hai Dil Ki Kahaan – The Great Gambler 1975
Tu Jaha Mai Woha – Salaam Namaste
Aaj Phir Tumpe Pyaar Aaya Hai – Hate story 2
Pehla Pehla Pyaar Hai – Hum Aapke Hai Kaun
Haal -e Dil  – Murde 2
Tujh Mein Rab Dikhta hai – Rab Ne Bana Di Jori
Kaho Na Kaho Ye aankhe Bolti hai sanam – Murder 2
Zara Zara Touch me toch me – Race 2
Saari Raat Teri Yaad Mujhe Aaati Rahi – Footpath
Hotho se chhoo lo tum
Ye Haseen Wadiyan
jiya dhadak dhadak jaaye 
Dheere dheere se meri zindagi me aana – Ashiqui
Saanso ki jarurat hai jaise – Ashiqui 
Mein Jahan Rahoon – Namastey London
Tu Hai Ki nahi
Tip Tip Barsa Paani – Mohra
Saawan aaya Hai 0- Creaure 3D
Agar Tum Mil Jaao  Jamana Chhor De
Zara Zara Mehakta hai Aaj – Rehna Hai Tere Dil Me 2001
Surili Aankhiyo Waale – VEER
Tum Dil Ki Dhadkan Me Rahte Ho – Dhadkan
Pehl Nazar me Kaisa Zaadu kr diya – Race
Wada Raha – Khakee
Banjara – Ek Villain
Teri Galiyaa – Ek Villain
Teri Ore – Singh is King
Hey Shona Hey Shona – Tara Rum Pum
Ek Mulakat Zaruri hai Sanam
Saanu ik Pal chain na Aaawe o Sajna tere bina
Tu mohabbat hai – Tere Naal Love Ho Gaya
Mai Shayar to Nahi – Bobby
Tuhi Meri Shab hai Subah Hai – Gangster
Falak Tak Chal Saath Mere – Tashan
Hua Hai Aaj Pehli Baar – Sanam Re
Tere Ishq ki mujhko  Aadat hai – One night Stand
Sonch Na Sake – Airlift 2016
Jeena Jeena – Badlapur
Raabta
73 Katra Katra – Alone
Tu Zarori Sa hai Mujhko Zinda Rahne Ke liye – Zid
Mareeze Ishq Hu Mai – Zid
Janam Janam Saath Chalna yunhi – Dilwale 2
Saanso Ko Jeene Ka Ishara Mil Gaya – Zid
Khamoshiyaa – Khamoshiyaa
Mai Tennu Samjhawa Ki – Humpty Sharma Ki dulhania
Gerua – Dilwale
Humari Adhuri Kahaani – Humari Adhuri Kahani
Zaroori Tha – Album Rahat Fateh Ali Khaan
Dhal Jaau Mai – Rustom
Tere Sang Yaara – Rustom
Saathi Re – Kapoor Sons
Tum Jo Mile – Bollywood Album Singles
Teri meri kahaani
Hangover – Kick
Joganiyan
Allah waariyan
Aye khuda
Pee Loon
Dil de diya hai
Dil tu hi bataa
Be intehaan
Chahun main ya naa
Lahu munh lag gaya
kabhi neem neem
Pyar toh hona hi tha
Meherban